G E G G W W W W W W W W W W W W W W W W
G G G G W G G G G G G G G G G G G G G W
G G G G W G G M M G G G G T T T T G G W
G G G G W G G Z Z Z M G G T L T T G G W
G G G G W G G Z L Z M G G T T T T G G W
G G G G W G G Z Z Z G G G G G G G G G W
G G G G W G G G G G G G G G G G G G G W
G G G G W G G G G G G G G G G G G G G W
G G G G G G G G G G G G G G G G G G G W
G G G G G G G G G G G G G G G G G G G W
G G G G G W W W W W W W W W W W W W W W
G G G G G G G G G G G G G G G G G G G G
G G G G G G G G G G G G G G G G G G G G
W W W W G G G G G G G G G G G G G G G G
W T H G G G G G G G G G G G G G G G G G
W T H G G G G G G G G G G G G G G G G G
W W W W G G G G G G G G G G G G G G G G
W T G G G G G G G G G G G G G G G G G G
W T G G G G G G G G G G G G G G G G T G
W T G G G G G G G G G G G G G G G G T G
W W W W G G G G G G G G G G G G G G G G
G G G G G G G G G G G G G G G G G G G G
G G G G G G G G G G G G G G G G G G G G
G G G G G G G G G G G G G G G G G G G G
G G G G G G G G G G G G G G G G G G G G
W G G G G G G G G W G G G G G G G G G G
W G G G G G G G G W G G G G G G G G G G
W G G T T T G G G W G G G G G G G G G G
W G G T T T G G G W G G G G G G G G G G
W G G T T T G G G W G G G G G G G G G G
W G G T T T G G G W G G G G G G G G G G
W G G G G G G G G W G G G G G G G G G G
W G G G G G G G G W G G G G G G G G G G
W W W W W W W W W W G G G G G G G G G G
