G E G G W W W W W W W W W W W W W W W W
G G G G W G G G G G G G G G G G G G G W
G G G G W G G M M G G G G T T T T G G W
G G G G W G M L L Z G G G T L T T G G W
G G G G W G M L T L M G G T T T T G G W
G G G G W G G Z Z Z G G G G G G G G G W
G G G G W G G G G G G G G G G G G G G W
G G G G W G G G G G G G G G G G G G G W
G G G G G G G G G G G G G G G G G G G W
G G G G G G G G G G G G G G G G G G G W
G G G G G W W W W W W W W W W W W W W W
G G G G G G G G G G G G G G G G G G G G
G G G G G G G G G G G G G G G G G G G G
W W W W G G G G G G G G G G G G W W W W
W T H G G G G G G G G G G G G G G G T W
W T H G G G G G G G G G G G G G G G T W
W W W W G G G G G G G G G G G G W W W W
W T G G G G G G G G G G G G G G G G T W
W T G G G G G G G G G G G G G G G G T W
W T G G G G G G G G G G G G G G G G T W
W W W W G G G G G G G G G G G G W W W W
G G G G G G G G G G G G G G G G G G G G
S G G G G G G G G G G G G G G G G G G Q
S G G G G G G G G G G G G G G G G G G Q
G G G G G G G G G G G G G G G G G G G G
W G G G G G G G G W W G G G G G G G G W
W G G G G G G G G W W G G G G G G G G W
W G G C C C C G G W W G G C C C C G G W
W G G C T T C G G W W G G C T T C G G W
W G G C T T C G G W W G G C T T C G G W
W G G C C C C G G W W G G C C C C G G W
W G G G G G G G G W W G G G G G G G G W
W G G G G G G G G W W G G G G G G G G W
W W W W W W W W W W W W W W W W W W W W
