G G G G G G G G G G G G G G G G G G G G
G G G G W W W W W W W W W W W W W G G G
G G G G W G G G G G G G G G G G W G G G
G G G G W G G G G G G G G T L T W G G G
G G G G W G G T L T G G G T T T W G G G
G G G G W G G T T T G G G G G G W G G G
G G G G W G G G G G G G G G G G W G G G
G G G G W G G G G G G G G G G G W G G G
G G G G G G G G G G G G G G G G G G G G
G G G G G G G G G G G G G G G G G G G G
G G G G G G G G G G G G G G G G G G G G
G G G G G G G G G G G G G G G G G G G G
G G G G G G G G G G G G G G G G G G G G
G G G G G G G G G G G G G G G G G G G G
G G G G G G G G G G G G G G G G G G G G
G G G G G G G G G G G G G G G G G G G G
G G G G G G G G G G G G G G G G G G G G
G G G G G G G G G G G G G G G G G G G G
G G G G G G G G G G G G G G G G G G G G
G G G G G G G G G G G G G G G G G G G G
G G G G G G G G G G G G G G G G G G G G
G G G G G G G G G G G G G G G G G G G G
G G G G G G G G G G G G G G G G G G G G
G G G G G G G G G G G G G G G G G G G G
G G G G G G G G G G G G G G G G G G G G
G G G G G G G G G G G G G G G G G G G G
G G G G G G G G G G G G G G G G G G G G
G G G G G G G G G G G W W W W W W W W W
G G G G G G G G G G G G G G G G G G G G
G G G G G G G G G G G G G G G G G G G G
G G G G G G G G G W G G G G G G G G G G
G G G G G G G G G W G G G G G G G G G G
G G G G G G G G G W G G G G G G G G G G
G G G G G G G G G W G G G G G G G G G G
